Input forms:
=jeNe	=bjeNe
Tgia	Tbgia
Tree	Tbree
TnIja	TbnIja
=gura	=bgura
ccia	cmcia
=guri	=bguri
TTia	TmTia
zrodom	zbrodom
=dEi	=bdEi
Nsui	Nmsui
tnydi	tbnydi
=ziE	=mziE
Nluam	Nbluam
hlelO	hblelO
kKuu	kmKuu
=ziE	=bziE
frakaS	fbrakaS
=Seet	=bSeet
rkOa	rbkOa
Srurog	Sbrurog
zrwgW	zbrwgW
TrwgW	TbrwgW
hree	hbree
NlUom	NblUom
Sjana	Sbjana
TkAO	TmkAO
=leeG	=bleeG
Tnoka	Tbnoka
ccea	cmcea
kkaaS	kbkaaS
=rai	=brai
gnwdi	gbnwdi
Tlili	Tblili
Zgia	Zbgia
TvAer	TbvAer
KkUom	KbkUom
ccikO	cmcikO
Tnii	Tbnii
=sata	=msata
=gurAl	=bgurAl
frui	fmrui
hrwgW	hbrwgW
snadi	smnadi
GGaa	GbGaa
hguO	hmguO
troGi	tmroGi
=heem	=bheem
=Gue	=bGue
Tnoti	Tbnoti
druva	dmruva
hSui	hmSui
pcii	pmcii
Stutog	Sbtutog
sbay	sbbay
=gAi	=bgAi
=redW	=bredW
=niga	=bniga
=nuci	=mnuci
TkAO	TbkAO
lkwi	lmkwi
pswe	pmswe
rZia	rmZia
tnyci	tbnyci
=lavi	=blavi
=Gee	=bGee
=cia	=mcia
cliu	cmliu
Tnii	Tmnii
dpula	dmpula
fnaki	fmnaki
hnaci	hmnaci
kriTi	kmriTi
psukO	pmsukO
rnoGoS	rbnoGoS
SjatoS	SbjatoS
Snyi	Sbnyi
sjia	smjia
=raaN	=braaN
=nana	=bnana
=nedi	=bnedi
=ziom	=bziom
=koE	=mkoE
=rodaS	=brodaS
TTaka	TbTaka
TnegW	TbnegW
Tlili	Tmlili
Tsui	Tmsui
fkia	fmkia
gsuti	gmsuti
hrwgi	hmrwgi
hrwgW	hmrwgW
kkaSi	kmkaSi
kcOi	kmcOi
klua	kmlua
lzaa	lbzaa
lnaGi	lbnaGi
nroci	nbroci
pciUr	pmciUr
rmIel	rbmIel
SSuog	SmSuog
snetem	sbnetem
scoi	smcoi
tgiriS	tbgiriS
tnyTi	tbnyTi
vreSi	vbreSi
=bau	=mbau
=laku	=blaku
=dAi	=bdAi
=geEr	=bgeEr
=jeNuS	=bjeNuS
=gien	=bgien
=niog	=bniog
=roSi	=broSi
=guor	=bguor
=nuTi	=bnuTi
=nudi	=bnudi
bkoko	bmkoko
clia	cmlia
clua	cmlua
Tlai	Tmlai
Treeg	Tbreeg
TlilAm	TblilAm
Tkoi	Tmkoi
Tsoi	Tmsoi
TkOi	TmkOi
Tnwgwtt	Tbnwgwtt
draa	dbraa
dcui	dbcui
druci	dbruci
flee	fmlee
fSoi	fmSoi
fruTa	fbruTa
frUok	fbrUok
frydi	fbrydi
fryge	fbryge
gbaO	gbbaO
gcei	gbcei
gguli	gbguli
GmEAn	GbmEAn
Gsui	Gmsui
Grukes	Gbrukes
hlai	hmlai
hmai	hbmai
hjade	hbjade
hNAi	hbNAi
hnuci	hmnuci
hmymw	hbmymw
jluuS	jbluuS
jluTi	jbluTi
jluTuS	jmluTuS
jluka	jbluka
ktaa	kmtaa
kKau	kmKau
kjaTi	kmjaTi
kkeec	kmkeec
kNwvi	kmNwvi
kruuKK	kbruuKK
kKua	kmKua
kKui	kmKui
kKyy	kmKyy
lcOi	lmcOi
lkusuS	lbkusuS
Nsui	Nbsui
NZyi	NmZyi
ptaron	pmtaron
pKiu	pmKiu
prwge	pmrwge
rnedi	rbnedi
rnedWr	rbnedWr
SrAi	SmrAi
StEa	SmtEa
Srwi	Smrwi
sdaO	smdaO
skesi	sbkesi
skEem	sbkEem
siO	smiO
smoor	sbmoor
ssuog	smsuog
snudi	sbnudi
tNaa	tmNaa
tnAci	tmnAci
tvee	tmvee
tvei	tmvei
tnydEr	tbnydEr
vGeEs	vbGeEs
vcia	vmcia
vrwwS	vbrwwS
zbai	zmbai
zloa	zbloa
zhuog	zbhuog
ZdiO	ZbdiO
Test forms:
grea
